111111111111111111111111111111111
100EC00000C00000C0000000100000001
1000N0000000N000000C0000C00000001
100000000000000000000000001000001
1000000100000000P0000000000000001
100000000000000000000N0000C000001
1000000000E0N00000000000001000001
111111111111111111111111111111111